1111111111111111111111111111111111
1E0000000000000C00000C000000000001
1010010100100X00101001000000010101
10X0100101010100010010000000101011
10P000000C00C0000X0000000000X000C1
1111111111111111111111111111111111