1111111111111111111111111111111111
1E0000000000000C00000C000000000001
1010010100100X00101001000000010101
10X01P0101010100010010000000101011
100000000C00C0000X00000000000000C1
1111111111111111111111111111111111