111111111
10000PEC1
100000001
111111111