111111111111
100P00000001
10E000000C01
111111111111