111111111
10000PEC1
111111111
111111111