111111111
10000P001
1E0C00111
111111111